aamu	утро
aamiainen	завтрак
aamupäivä	первая половина дня
Aasia	Азия
aasialainen	азиат
afrikkalainen	африканец
aherrus	труд
ahven	окунь
Ahvenanmaa (saaristoalue)	Аландские острова
Ai	Aх.
Ai jaa.	Aх так.
Ai niin.	Aх да.
aiemmin	раньше
aika (= melko)	довольно...
aika	время
aika lailla (= melko paljon)	порядочно
aika tavalla (= melko paljon)	довольно много
aikuinen	взрослый
aina	всегда ainakaan (> ainakin) по крайней мере не, во всяком случае не ainakin ? ei ainakaan по крайней мере, во всяком случае
ainoa	единственный
ainoastaan	только, лишь
aivan	совсем, совершенно; точно
ajaa	водить; возить; ездить; про/вы/изгонять и проч
ajanvaraus	запись на прием (к врачу); назначенная встреча (в учреждениях и проч.)
ajatella	мыслить, думать
ajatus	мысль
ajella	ездить; кататься
ajokeli	состояние дороги (хорошее, плохое...)
alahylly	нижняя полка
alakaappi	нижний шкаф
alakerta	нижний этаж
alas	вниз
alhaalla	внизу
alkaa	начинаться
alku	начало
alkupala	закуска
alla	под (кем-чем)
allas	бассейн; раковина
allekirjoitus	подпсиь
aloittaa	начинать aluksi (> alku) для начала, сначала, вначале (> начало) (транслатив ед. ч.)
alusvaate	[нижнее] белье
ambulanssi	машина скорой помощи
Amerikka	Америка, США
amerikkalainen	американец; американский
ampua	стрелять
ansaita	зарабатывать; заслуживать
ansio	заработок; заслуга
antaa	давать; дарить
antaa anteeksi	прощать, извинять
apteekki	аптека
apu	помощь
arkipäivä	будний день
artikkeli	статья
arvata	от/раз/угадывать; догадываться
arvostelija	критик; рецензент
arvostelu	оценка; критика; рецензия
asema	вокзал; станция; положение
asia	дело, вещь, вопрос
asiakas	клиент
aste	стадия, ступень, степень; градус; инстанция
asti	до (кого-чего), по (что); от, с (чего)
astia	посуда, посудина
astialaatikko	ящик для посуды
astianpesuaine	посудомоечная жидкость
astianpesukone	посудомоечная машина
asua	жить; проживать
asua vuokralla	жить в наемной квартире, снимать квартиру
asunto	квартира
aukaista	открывать
auki	открыто; расстегнуто; включено и проч.
aula	холл, вестибюль; фойе
aurinko	солнце
auto	автомобиль, машина
autoilija	автомобилист
autolautta	автомобильный паром
auttaa	помогать
avain	ключ
avata	открывать; раскрывать; отпирать; включать и пр.
avioliitto	брак
avulias	готовый помочь    
 	 
B	Наверх
baari	бар; буфет; закусочная
B-kansi	палуба Б
bussi	автобус  
 	 
C	Наверх
C-vitamiini	витамин С    
 	 
D	Наверх
dollari	доллар [США]    
 	 
E	Наверх
edelleen	дальше, далее; по-прежнему
edellinen	предыдущий, прошлый
edes	хотя бы, хоть; даже не
edessä	впереди; перед (кем-чем)
edestakainen	туда и обратно (путь, билет и т. п.)
edullinen	выгодный, дешевый
ehdoton	безусловный, абсолютный
ehdottaa	предлагать
ehdottomasti	безусловно, абсолютно; обязательно
ehdotus	предложение
ehkäд	может быть; возможно
ehtiä	успевать
ei	не; нет
Ei kestä.	Не за что (в ответ на спасибо).
ei koskaan	никогда
ei kukaan	никто
ei mikään	ничто
ei	mitään (> ei mikддn) ничего (> ничто) (партитив ед. ч.)
Ei mitään erikoista.	Ничего особенного.
ei ollenkaan	совсем не[т]
Ei se mitään.	Это ничего.
ei tarvitse	не надо, не нужно
eikö niin	Не так ли?
eilen	вчера
ekonomi	бакалавр экономических наук
eli	или; то есть; другими/иными словами
elokuu	август
elokuva	кинофильм elokuviin (>
mennä elokuviin)	в кино (> идти в кино)
eläke	пенсия
eläkkeellä	(> olla eläkkeellä) на пенсии (> быть на пенсии)
elämys	переживание, впетчатление, ощущение
elämä	жизнь
elää	жить
en	я не[т]
enemmän	больше, более
Englanti	Англия
englantilainen	англичанин; английский
enkä (= ja en)	и/а я не[т]
ennen	раньше; прежде; до (кого-чего); перед (кем-чем)
ensi	первый; будущий, следующий
ensi-ilta	премьера
ensimmäinen	первый
ensin	первым делом; сначала, сперва; во-первых
entinen	бывшый; прежний
Entä itsellesi?	А ты? А у тебя как? А тебе что?
enä	уже (не) ; больше (не) ; только
eri	разный, другой
eri mieltä	другого мнения, не согласен
erikoinen	особенный; особый, специфический; своеобразный
erikoislääkäri	врач-специалист
erilainen	разный, различный
erittäin	очень, весьма; особенно; чрезвычайно eronnut (> erota) разведенный (> разводиться с кем)
erota (= olla erilainen)	отличаться
erota	разводиться (с кем)
esikoinen	первенец
esimerkiksi	на пример
esine	предмет, вещь
esitellä	показывать, демонстировать; докладывать, знакомить (с чем); представлять (кого кому)
esittä	предъявлять, показывать; высказывать, выражать; представлять; исполнять, играть; изображать
esitys	представление; выступление; изложение
eteen	вперед; перед (кем-чем); для, ради (кого-чего)
eteenpäin	вперед; дальше, далее; [начиная] с (чего)
etelä	юг
etsiä	искать
että	что
euro	евро
 	 
F	Наверх
fiksu	сообразительный; толковый; остроумный; умница
file	филе
Firenze	Флоренция
firma	фирма
flunssa	грипп
fraasi	речевой оборот, выражение, фраза    
 	 
G	наверх ylos
glögi	глинтвейн
graavi	свежепросоленный
graavilohi	свежепросоленная лососина
grillimakkara	колбаса, жареная на гриле    
 	 
H	Наверх
haalari	комбинезон; спецодежда
haarukka	вилка
haastattelija	берущий интервью, интервьюер
haista	пахнуть, вонять
haitata	мешать, затруднять
hajota	разваливаться, распадаться, ломаться
Hakaniemi (kaupunginosa Helsingissд)	Хаканиеми (один из районов Хельсинки)
hakea	*сходить/*съездить (за кем-чем); искать; подавать [заявление] (на что)
halata	обнимать
halpa	дешевый, недорогой
haluta	хотеть; желать
hame	юбка
hammas	зуб
hammaslääkäri	зубной врач, стоматолог
hampurilainen	гамбургер
hangata	тереть; натирать; стирать (резинкой и т.п.) и пр.
hankkia	доставать; приобретать; снабжать
hansikas	перчатка
harmi	досада; неприятность
hassu	дурашливый, дурацкий; чудак; нелепый; забавный, смешной
hauki	щука
hauska	веселый; смешной, забавный; приятный
he	они
Hei	Привет!
hei hei	Пока!
heinäkuu	июль
heippa	Привет! Пока!
helmikuu	февраль
helpottaa	облегчать
helppo	легкий
hengittää	дышать
henkari	вешалка
henki	дух; жизнь; человек; воздух, дыхание
henkilö	лицо; личность; персонаж
henkilökunta	персонал
henkilällisyystodistus	удостоверение личности
hermostua	*разнервничаться; нервничать
Herrajumala	Господи! Боже мой!
herätä	просыпаться
heti	сразу, сейчас
hetkeksi	на минутку
hetki	минута, момент
hetkinen	минутка
hidas	медленный
hiekoittaa	посыпать песком
hieno	отменный, прекрасный; изящный; тонкий
hiihtää	ходить на лыжах
hinta	цена, стоимость
hirveä	ужасный, страшный
hissi	лифт
hitaasti	медленно
hoitaa	ухаживать, заботиться; лечить и проч.
hoitaja	медсестра
hoito	уход; лечение, курс лечения
Hollanti	Голландия
homma	дело (замысел)
hotelli	гостиница, отель
hotellihuone	номер в гостинице
housut	брюки, штаны
hovimestari	метрдотель
huhtikuu	апрель
hulina	суматоха
hullu	безумный, сумасшедшый; дурацкий
huolehtia	заботиться, следить (за кем-чем); беспокоиться
huoli	забота; беспокойство
huomata	замечать; обнаруживать
huomenna	завтра
Huomenta!	Доброе утро!
huone	комната
huonekalu	предмет мебели
huono	плохой; дурной; неблагоприятный
huumori	юмор
huutaa	кричать
hymyillä	улыбаться
hypätä	прыгать
hytti	каюта; кабина
hyttynen	комар
hyvin	хорошо
hyvä	хороший; добрый
hyvдstelyt	прощание
Hyvää huomenta!	Доброе утро!
Hyvää iltaa!	Добрый вечер!
Hyvää jatkoa.	Всего хорошего! Счастливо!
hyvää joulua	С Рождеством Христовым!
Hyvää pдivää!	Добрый день!
Hyvää yötä	Спокойной ночи!
hyödyllinen	полезный
häiritä	мешать; беспокоить; нарушать
hän	он, она
härkä	вол, бык
hätä	беда
hätäntyä	пугаться; растериваться
hääpari	молодые, жених и невеста
häät	свадьба
hökötys	штука, штуковина
höpistд	бормотать; болтать
höpsis	Ерунда!    
 	 
I	Наверх
idea	идея
ihan	совсем
ihana	чудный, чудесный; прекрасный; удивительный; очаровательный и т. п.
ihanasti	чудно; прекрасно; удивительно и т. д.
ihme	чудо
ihmeellinen	удивительный, чудесный; чудный
ihminen	человек
ikivanha	древний, вековой; исконный
ikkuna	окно
ikuisuus	вечность
ikä	век, жизнь
ikä	возраст
ikäinen	-летний
ilma (= sдд)	погода
ilmaista	выражать
ilman muuta	конечно, обязательно; безо всяких, просто так
ilmansuunta	страна света
ilmoittautuminen	запись, регистрация, подача заявок
ilmoitus	сообщение, объявление, заявление; реклама
ilta	вечер
Iltaa!	Добрый вечер!
iltapäivä	вторая половина дня
inhota	испытывать/питать отвращение (к кому-чему); ненавидеть, не мочь терпеть (кого-что)
inventaario	инвентарь
islantilainen	исландец; исландский
iso	большой; крупный
isoisä	дедушка
isoveli	старший брат
isoäiti	бабушка
istua	сидеть
istuva	сидящий
isä	отец
itse	сам, сама
itse asiassa	по сути дела
itsepalvelupesula	прачечная самообслуживания
itä	восток
itämurre	восточный диалект
Itä-Suomi	Восточная Финляндия
 	 
J	Наверх
ja	и
jaksaa	поживать, чувствовать себя; (не) мочь больше, быть (не) в силах
jalka	нога
jatkaa	продолжать
jatko	продолжение
jatkua	продолжаться
jauheliha	рубленое мясо, фарш
jeesata (= auttaa)	помогать (разг.)
jo	уже; еще
Joensuu (kaupungin nimi)	Йоенсуу (название города)
johonkin	куда-то, куда-нибудь
johtaja	руководитель; директор; заведующий; лидер и пр.
joka (jokainen)	каждый
joka (relatiivipronomini)	который
joki	река
jokin	что-то, кое-то, что-нибудь
joku	что-то, кое-то, что-нибудь
joku	кто-то, кое-кто, кто-нибудь
jonkin verran (= vдhдn)	немного, мало
jonnekin	куда-то, куда-нибудь
jono	очередь
joo	Да
jos	если
joskus	иногда
jotain	инодга, порой; когда-то, некогда; когда-нибудь
jotakin	что-то, что-нибудь
joten	так что
joulu	Рождество
jouluaatto	рождественский сочельник
jouluhulina	предрождественская суматоха
joulukuu	декабрь
joulukuusi	[рождественская] елка
joululahjakirja	книга, подаренная на Рождество
jouluostos	покупки на Рождество
joulupukki	Дед Мороз
joulupäivä	день Рождества
joulurauha	рождественский покой
jouluruuhka	заторы людей и машин до и после Рождества
joulustressi	предрождественский стресс (связанный со всеми нужными и ненужными приготовлениями)
jouluvalmistelu	предрождественские приготовления
jouluvalot	рождественские огни (праздничное освещение города и частных домов)
jousto	эластичность; гибкость; гибкий режим работы; уступок
juhla	праздник; торжество; юбилей
juhlahame	праздничная/выходная юбка, праздничный наряд
juhlapäivä	праздник, праздичный день
juhlia	праздновать, отмечать; веселиться
juna	поезд
junamatka	поездка/проезд на поезде
juoda	пить; выпивать
juoma	напиток; питье
juosta	бегать
jutella	разговаривать
juttu	история; статья; дело
juures	корнеплод
juuri (= hetki sitten)	только что
juuri	корень; подножие
juusto	сыр
juustosämpylä	сайка с сыром
jyrähdys	удар; грохот
jälkeen	после
jälkiruoka	десерт, сладкое
jännittävä	захватывающий; интересный
järjestysluku	порядковое числительное
järjestää	устраивать; организовать; систематизировать
järvi	озеро
jättää	оставлять; бросать
jää	лед
jäädä	оставаться
jääkaappi	холодильник
jäätelö	мороженое
jäätyä	леденеть; замерзать    
 	 
K	Наверх.
kaapelitehdas	кабельный завод
kaappi	шкаф
kaasu	газ
kadunkulma	угол улицы
kahdeksan	восемь
kahdeksankymmentä	восемьдесят
kahdeksantoista	восемнадцать
kahdeksanvuotias	восьмилетний
kahdeksas	восьмой
kahdeskymmenes	двадцатый
kahvi	кофе
kahvikuppi	кофейная чашка; чашка кофе
kahvila	кафе, кафетерий
kahvimuki	кофейная кружка
kahvinkeitin	кофеварка
kai	наверно, наверное; пожалуй
kaihdin	штора
kaikki	все, всё
kaiutin	репродуктор; громкоговоритель
kaivata	тосковать (по кому-чему) не хватать (кому кого); нуждаться (в чем), требовать (кого-чего)
kakkonen	двойка
kakkosasunto	вторая квартира
kakku	кекс; торт
kaksi	два
kaksikymmentä	двадцать
kaksistaan	вдвоем
kaksitoista	двенадцать
kaksitoistavuotias	двенадцатилетний
kala	рыба
kalakeitto	уха, рыбный суп
kalastaa	ловить рыбу, рыбачить
kalenteri	календарь
kalja	пиво (разг.); квас
kallis	дорогой
kalsarit	трусы; кальсоны (разг.)
kamala	ужасный, страшный
kammata	причесывать[ся]
kampa	расческа, гребенка
Kanariansaaret	Канарские острова
kangas	ткань
kannattaa	поддерживать; стоить (например в смысле "стоит попробовать"); [фирма] рентабельна
kannu	кувшин
kansa	народ
kanssa	с (кем-чем)
kappale	кусок; абзац, отрывок; экземпляр; штука; тело; вещь
karjalanpiirakka	карельский пирожок (пирожок с рисом или с картофельным пюре)
karkkia (= karamelli)	конфетка (партитив ед. ч.)
kartta	карта; план
kasi	восьмерка
kassi	сумка; [полиэтиленовый] пакет
kastejuhla	крестины
kasvis	овощ
kasvisruoka	вегетарианское блюдо, растительная пища
katsella	смотреть, осматривать
katsoa	смотреть, глядеть
katu	улица
kauan	долго; давно
kauhea	ужасный, страшный
kaukana	далеко; вдали, вдалеке
kaulaliina	шарф
Kauniita unia.	Приятных сновидений!
kaunis	красивый, прекрасный
kauppa	магазин, лавка; торговля; сделка
kauppahalli	крытый рынок
kauppias	торговец; владелец магизина; купец; продавец
kaupunginosa	район, часть города
kaupunki	город
kautta	через (кого-что)
kaveri	приятель
kehua	хвалить; хвастаться
keittiö	кухня
keittää	варить
kelakortti	карточка медицинского страхования (выдается Пенсионным управлением "КЕЛА")
keli	состояние дорог (зависящее от погодных условий)
kello	часы; (который) час
kelvata	годиться; действительный (билет)
kenkä	туфля, ботинок
kenkäkauppa	магазин обуви
kerma	сливки
kerrata	повторять
kerros	этаж
kerrostalo	многоэтажный дом
kerrostaloasunto	квартира во многоэтажном доме
kerta	раз
kertoa	рассказывать; множить
kerätä	собирать; набираться
keskari (= keskiolut)	пиво средней крепости (разг.)
keskellä	посередине, посреди, в середине; среди (кого-чего), в центре (чего)
kesken	незаконченный; между (кем-чем)
keskeyttää	прерывать; перебивать
keskimmäinen	средний
keskiviikko	среда
keskusta	центр (города и т. п.); партия центра
keskustella	разговаривать; обсуждать
kestävä	прочный, устойчивый
kestää	выдерживать, переносить; держаться; длиться
kesä	лето
kesäkuu	июнь
kesäloma	летний отпуск, летние каникулы
kesämökki	[летняя] дача
kesätapahtuma	культурные мероприятия, организуемые в летнее время по всей Финляндии
kesäyliopisto	летний университет
keuhkot	легкие
kevät	весна
kieli	язык; струна
kieltää	запрещать; отрицать; отказывать (кому в чем); отрекаться
kierros	круг; оборот; тур, раунд; [чья-то] очередь [угошать] kihloissa (> olla
kihloissa)	обручен, помолвлен (> обручаться)
Kiina	Китай
kiinni	закрыто; выключено; привязано и проч.
kiinnostava	интересный
kiinnostuksen kohde	предмет или человек, которым кто-то интересуется
kiire	спешка
kiireellinen	спешный, срочный, неотложный
kiirehtiä	спешить, торопиться; ускорять; торопить
kiitos	спасибо
kiitos kysymästä	Спасибо, нормально!
kiitti	спасибо (разг.)
kiivetä	лазить; взбираться, карабкаться
kilo	килограмм
kilometri	километр
kiltti	добрый, хороший; послушный, паинька
kinkku	ветчина; [рождественский] окорок
kioski	киоск
kipeä	больной
kippis	[За] ваше здоровье! (разг.)
kiristyä	обостряться; крепчать (о морозе)
kirja	книга
kirjasto	библиотека
kirje	письмо
kirjemaksu	почтовый сбор за письмо
kirjemerkki	почтовая марка для писем
kirjoittaa	писать
kirkas	яркий; ясный; прозрачный
kirkko	церковь; собор
kirpputori	толкучий рынок, барахолка
kisat	игры; соревнования
kissa	кошка
kissanruoka	корм/питание для кошек
kiva	интересный, отличный; клевый (разг.)
koe	экзамен; опыт, эксперимент, испытание; анализ
koettaa	пробовать, пытаться, стараться
kohta (= pian) ,	скоро, вскоре; сейчас
kohtelias	вежливый, любезный, галантный
koira	собака
koittaa (= yrittää)	стараться, пытаться
kokeilla	пробовать, испытывать, экспериментировать; примерять
koko (kokonainen)	весь; целый; полный
koko (suuruus)	размер, величина; рост; объем
kokoinen	величиной, размером (кого-что); [какого-то] размера/роста
kokous	собрание; заседание; съезд; митинг; конференция
kolikko	монета
kolme	три
kolmekymmentä	тридцать
kolmetoista	тринадцать
kolmonen	тройка
komea	интересный, красивый; видный; роскошный, великолепный, пишный, шикарный
kone	машина
konepelti	карот
konjakki	коньяк
konsertti	концерт
koristella	украшать
korjaaja	тот, кто чинит, исправляет, ремонтирует
korjata	чинить, исправлять, ремонтировать
korkea	высокий
kortti	открытка; карточка; карта
koru	украшение; ювелирное изделие; бижутерия
koskea (= sattua, olla kipeд)	болеть, больно
koti	свой угол, домашний очаг, дом
koti-ilta	вечер, проведенный/проводимый дома
kotimaa	родина
kotimainen	отечественный; внутренний
kotoisin	родом откуда-то
kotona	дома
koukku	крюк, крючок
koulu	школа
koulutoveri	соученик, школьный товарищ
kova (= voimakas, ankara)	сильный; строгий, суровый
kovaa (= voimakkaasti)	сильно, крепко; громко
kovasti	много, очень; сильно, крепко; строго
kovin	очень
kuha	судак
kuhafile	судаковое филе
kuin	чем; как
kuinka	Как? Сколько?
kuitenkin	все же, все-таки, все равно, однако, тем не менее
kuittaus	расписка
kuivausrumpu	сушильный барабан
kuivua	сохнуть, вы/за/просыхать; иссякать
kuivuminen	высыхание, засыхание
kuka	кто kukaan (> ei
kukaan)	> никто
kulho	миска, чашка
kulkea	ходить, ездить; двигаться
kulma	угол; край, сторона
kulta	 золо[т]ко
kulua	изнашиваться, истираться; уходить (на что); идти, проходить (о времени)
kuluessa (aikana)	в течение, во время (чего)
kuluttua	через, спустя
kumpi	который [из двух]
kumpikin	и тот, и другой; оба, обе
kun	когда; пока не
kunnolla	как следует, хорошо, прилично
kunnollinen	порядочный, приличный; [благо]пристойный
kuntoilla	заниматься физкультурой
kuollut	мертвый, умерший
kuppi	чашка
kurja	жалкий, убогий; скверный; скучный
kurkku	горло
kurkkukipu	боль в горле
kutsua	приглашать; собирать, созывать; звать, призывать; вызывать; называть[ся]
kuudes	шестой
kuudestoista	шестнадцатый
kuukausi	месяц
kuule	слушай
kuulemiin	До свидания! (по телефону)
kuulua	слышаться; гласить, звучать; принадлежать; касаться; следовать, надлежать и проч.
kuuluisa	известный, знаменитый
kuulumisia	новости, дела (партитив мн. ч.)
kuuma	жаркий; горячий
kuume	жар, [повышенная] температура
kuumemittari	градусник
kuunnella	cлушать, про/выслушивать; прислушиваться (к кому-чему), слушаться (кого-чего)
kuusi (joulukuusi)	ель; eлка [рождественская]
kuusi	шесть
kuusikymmentä	шестьдесят
kuusitoista	шестнадцать
kuutonen	шестерка
kuva	картинка, рисунок, изобразение, иллюстрация; картина, портрет; фото[графия]; отражение; образ, представление; имидж и проч..
kyllä	да (ответ)
kylmetä	холодеть, охлаждаться; стынуть, остывать
kylmyys	холод, стужа; холодность
kylmä	холодный
kylpy	купание; ванна
kylpyamme	ванна
kylpyhuone	ванная
kylpylä	водно-оздоровительный центр; [курортный] санаторий; купальня; аквапарк; курорт
kylä	деревня, село, поселок
kymmenen	десять
kymmenes	десятый
kymppi	десятка
kynttilä	свеча, свечка
kysyminen	спрашивание
kysymys	вопрос (>
kysyä	спрашивать
kyyti	провоз; транспорт; подвозить (кого-то)
kännykkä	мобильный телефон
käsi	рука
käteinen	наличные
käteisellä	наличными
kätevä	умелый; удобный
kävellä	ходить, идти [пешком]; гулять; прогуливаться
kävely	ходьба; прогулка kдvit (> kдydд) ты [с/за]ходил/[съ]ездил/заезжал и т. д. (>[с/за]ходить и др.)
käydä sisään (= astua sisддn)	входить
käyttää	пользоваться, использовать, употреблять; применять; эксплуатировать, работать (чем); носить (одежду), ходить (в чем)
käyttä	[ис]пользование, употребление; применение; эксплуатация; обиход и проч.
käytävä	ход, переход; коридор; кулуары
kääntää	поворачивать; переводить и проч.    
 	 
L	Наверх
laadukas	качественный
laatikko	ящик
laatu	качество
lahja	подарок; дар[ование], талант
lahjakortti	подарочный чек
lahjapakkaus	подарочная упаковка
lainata	занимать, брать взаймы; одалживать, давать взаймы; брать/давать (на время); заимствовать
laittaa päälle (= käynnistää)	 заводить, [за]пускать; включать
laituri	причал, пристань; перрон; платформа
laiva	корабль, теплоход, пароход; судно
lakana	простыня
lakkiaiset	выпускной вечер/выпускные торжества по поводу окончения гимназии (в честь полученной в этой связи белой фуражки)
Lappi	Лапландия
lapsellinen	детский; наивный
lapsenlapsi	внук, внучка
lapsi	ребенок
lasi	стекло; стакан, бокал, рюмка
lasillinen	стакан (чего)
laskea (= alentaa)	с/понижать; опускаться, падать
laskea (= kalkyloida)	считать; под/высчитывать; исчислять; расчитывать
laskea (mennä alas)	спускаться, съезжать
lasku	спуск; с/понижение, падение; подсчет; счет, кредит
lastenlapsi	внук, внучка
lastenosasto	детское отделение; детский отдел
lauantai	суббота
lautanen	тарелка
lavuaari	раковина
leffa	кинофильм; кинотеатр (разг.)
lehti	лист; газета; журнал
leikata (operoida kirurgisesti)	оперировать
leikkiä	играть (в куклы, казаки-разбойники и проч.)
leimahtaa	*вспыхнуть; *свекрнуть; *загореться
leimata	штемпелевать; компостировать; ставить клеймо, клеймить и проч.
leipoa	печь
leipä	хлеб
leirintäalue	кемпинг
leivos	пирожное
lempiruoka	любимое блюдо
lento	полет; рейс
lentokone	самолет
lentää	летать
lepo	отдых; покой
levyke	дискета
levätä	отдыхать
liha	мясо; плоть
lihapulla	битки
lihas	мышца, мускул
liian	слышком, чересчур
liikaa	слышком много
liike (= yritys, firma)	предприятие, фирма
liikutella	шевелить (что, чем)
liinavaate	белье
limsa (= limonadi)	лимонад (разг.)
lingota	отжимать (белье) центрифугой; метать из пращи, бросать
linja-autoasema	автовокзал
lintu	птица
lipas	шкатулка
lippu	знамя, флаг; билет; бюллетень
lippupalvelu	Билетная касса (предприятие)
lista	рейка, карниз, плинтус; список; топ
lisäke	придаток; присмесь; гарнир
litra	литр
liukas	скользкий; проворный; хитрый, ловкий
lohi	[cобственно] лосось; семга
lohikala	рыба из семейства лососевых
loistava	сияющий, блестящий; прекрасный, отличный, великолепный
lokakuu	октябрь
lokero	ячейка; отделение
loma	отпуск, каникулы
lomailla	отдыхать
lomamatka	турпоездка; путевка
lomaromanssi	роман с кем-то во время отпуска (обычно на юге)
lompakko	бумажник
Lontoo	Лондон
loppu	конец
loppupäivä	весь остальной день; к вечеру
loppuunmyyty	[рас]продано; аншлаг
loska	слякоть
lotto	лото, денежная лотерея
lottovoitto	выигрыш в лото; *посчастливиться (кому во чем)
lounas	ленч, обед; юго-запад
lounasruoka	ленч, обед; блюда, подаваемые на ленч/обед
luistella	кататься (на коньках/роликах); идти коньковым ходом
luistinrata	каток
lukea	читать; учить[ся], изучать, заниматься, готовиться; считать (кого-что кем-чем)
lukusanat	[имена] числительные
lumi	снег
lumisade	снег[опад]
luokka (koulussa)	класс (в школе)
luonne	характер; нрав
luottokortti	кредитная карточка
lusikka	ложка
luukku	люк, отверстие, заслонка; окошко, касса
luulla	думать; принимать (кого-что за кого-что)
luultavasti	вероятно
luvata	обещать
lähellä	близко, поблизости, недалеко
lähettää	посылать, отправлять; передавать (по радио и телевидению)
lähipäivä	ближайщий день
lähteä	*пойти, *поехать, *отправиться [в путь] и проч.
lдhteд käyntiin	заводиться; *заработать (о машине); *начинаться (о деятельности)
lähtö	отправление; уход; отъезд; старт
lämmetä	согреваться; нагреваться; теплеть
lämmin	теплый; горячий (о пище)
lämpö	тепло; теплота; температура
lämpötila	температура
länsi	запад
lääkдri	врач
löytää	находить, отыскивать; обнаруживать; открывать (что-то новое)    
 	 
M	Наверх
maa	земля, свет; суша; почва, грунт; деревня; страна; масть
maailma	мир, свет
maakunta	область, провинция
maalainen	деревенский, сельский (прил.); человек из деревни, провинциал; человек из какой-то страны
maalata	красить, окрашивать; накрашивать[ся]; писать (портрет)
maaliskuu	март
maanantai	понедельник
maaseutu	деревня, сельская местность; провинция
maata	лежать; спать (с кем)
mahdollinen	возможный; потенциаьный
mahtaa	мочь
mainio	отличный, замечательный, отличный, великолепный
mainos	реклама; объявление; афиша, анонс
maisema	пейзаж, ландшафт; вид
maistua	иметь какой-то вкус/вкус чего-либо; [не]вкусно; хотеть
maito	молоко
majoitus	 размещение(например в гостинице) проживание
makea	сладкий
makkara	колбаса
maksaa	платить;выплачивать; расплачиваться; стоить
maksikirje	письмо по размерам больше стандартного
makuuhuone	спальня
maljakko	ваза
malli	образец, модель; макет
mamma	бабушка (в Западной Финляндии); мама (со шведской интерференцией); [полная] женщина [среднего или пожилого возваста] (шутл.)
mansikka	земляника, клубника
marraskuu	ноябрь
masu (= vatsa)	желудок, живот
materiaali	материал
matka	дорога, путь; рейс; поездка; путешествие; тур, путевка
matkakohde	туристический объект
matkalaukku	чемодан
matkatoimisto	бюро путешествий, турагенство/-бюро/-фирма
matkustaa	ехать, ездить, летать
matkustella	путешествовать, ездить, разъезжать
matto	ковер; половик
me	мы
meinata	собираться сделать, намереваться; думать, иметь в виду (разг.)
mennä	идти, ехать
mennä elokuviin	идти в кино
mennä naimisiin	жениться, выходить замуж
meno	отглагольное существительное от mennä; встречается в самых разных оборотах речи, перевод полностью зависит от контекста
menolippu	билет туда/в один конец
meno-paluu	туда и обратно
meri	море; океан
meripihkakoru	ювелирное изделие из янтаря
meritaimen	морской таймень, морская кумжа
merkki	[oт/по]метка; знак, сигнал; марка; след; признак
Mersu (= Mercedes Benz)	Мерцедес (разг.)
meteli	шум
mieheni (mies)	мой муж/супруг
mielellään	охотно, с удовольствием
mielenkiintoinen	интересный
mielestä(ni)	на (мой) взглад, по (моему) мнению, (я) счита(ю)
mieli	душа; настроение; ум, голова; мнение, взгляд; смысл
mielipide	мнение, взгляд
mieluummin	лучше, препочтительно, скорее
mies	мужчина; муж, супруг
miestenhuone	мужской туалет, мужская уборная
mieto	слабый, некрепкий, легкий, неострый
miettiд	думать, размышлять; обдумывать
mihin	куда
mihin aikaan	Когда? В какое время? Во сколько?
miksi	Почему? Зачем? Отчего?
mikä	что [за], какой; что, который
mikäs siinä	Почему бы нет? Давай. Ладно.
millainen	какой, каков
milloin	когда
minkälainen	какой, какого рода
minttulikööri	мятный ликер
minuutti	минута
minä	я
missä	где
mistä	откуда
mitata	мерить, вымерять, отмеривать и т. п.
miten	как
Miten menee?	Как дела?
mitä	что
Mitä kuuluu?	Как дела? Что слышно? Что нового?
mitä mieltä	Что ты/вы думаешь/-ете? Как ты/вы считаешь/-ете? Как ты/вы относишься/-итесь? Ваше мнение?
moderni	современный
moi moi	Пока!
Moi!	Привет!
moikka (= moi)	Привет!
molemmat	оба, обе
monesko	который/какой (по счету); какое [число]?
moni	многие, много monta (> moni) > многие, много (партитив ед. ч.)
moottoripyörä	мотоцикл
morsian	невеста
muikku	ряпушка
muistaa	помнить; вспоминать; запоминать
mukaan	с (кем), с собой; по, согласно (кому-чему)
mukana	вместе с (кем), с собой; сопровождать (кого)
mukava	удобный; конфортабельный; уютный; приятный
mukavasti	удобно; конфортабельно; уютно; приятно
muki	кружка
mummola	дом бабушки, [у] бабушк[и], [к] бабушк[е]
murre	диалект; говор
museo	музей
musta	черный
mutta	но, а, однако
muu	другой, иной; кто/что-нибудь еще; прочий, остальной
muun muassa	в частности, в том числе; между прочим
muutama	несколько
muuten	иначе, а то; просто так; кстати, между прочим
muuttaa	[из/пере]менять; превращать; переезжать и проч.
muutto	переезд, переселение; миграция
muuttolintu	перелетная птица
muuttua	[из/пере]меняться; превращаться; делаться, становиться и проч.
myrsky	буря, шторм; циклон
myydä	продавать; сбывать
myyjä	продавец
myöhemmin	позже, позднее; потом, затем
myöhässä	поздно, с опозданием; опаздывать, задерживаться
myös	тоже; также
mäti	икра
määrätä	назначать, приказывать; устанавливать; распоряжаться; прописывать; определять
mökki	изба; домик; дача    
 	 
N	Наверх
naapuri	сосед (> mennд naimisiin)
naimisiin	> жениться, выходить замуж (> olla naimisissa)
naimisissa)	> женат, замужем
nainen	женщина; дама
nakki	сосиска
nappi	пуговица
nauttia	наслаждаться
ne	они, те
neliö	квадрат (квадратный метр)
neljä	четыре
neljäkymmentä	сорок
neljäs	четвертый
neljästoista	четырнадцатый
neljätoista	четырнадцать
nelonen	четвертка
nenä	нос
neuvoa	советовать; показывать
nielu	глотка
nieriä	голец
niin	так; да
nimi	имя; название
nippu	связка; пачка; пучок
no	так
No niin.	Да так. Ну что ж.
noin (= sillä tavalla)	так, таким образом
noin (= suunnilleen)	приблизительно
nolla	ноль, нуль
nopeammin	быстрее
nopeasti	быстро
Norja	Норвегия
norjalainen	норвежец; норвежский
nousta	подниматься; вставать; в/выходить (в/из автобус/а и т. п.); повышаться и проч.
nuha	насморк
nukahtaa	засыпать
nukka	ворс
nukkua	спать
Nuku hyvin.	Спи спокойно!
numero	номер; цифра; отметка
nuori	молодой, юный
nykyisin	в настоящее время, теперь, сегодня, ныне
nykyään	сегодня, ныне
nyt	теперь nдette (> nдhdд) вы видите (> видеть)
nähdä	видеть
nähdään	увидим[ся]; до встречи
näin	я видел[а]; [вот] как, [вот] такой
näkemiin	До свидания!
näkyvyys	видимость
nämä	эти; они
näytelmä	пьеса; спектакль
näyttelijä	актер
näyttely	выставка
näyttää	показывать; предъявлять; выглядеть, напоминать; кажется, похоже
näytös	акт, действие; показ, демонстрация    
 	 
O	Наверх
odotella	ждать, ожидать, поджидать, дожидаться
odottaa	ждать, ожидать, поджидать, дожидаться (часто по смыслу ближе к сов. виду); ждать ребенка
odotus	ожидание; беременность
ohi	мимо
ohittaa	проходить/-езжать мимо, миновать; обгонять, опережать; обходить
ohjata	управлять, править, водить; направлять; руководить; ставить (пьесу и проч.)
ohjelma	программа; передача (радио, телевидение)
oikea (= aito)	настоящий, подлинный, истинный
oikea	правый; правильный, верный
oikeastaan	собственно; в сущности, по сути дела; на самом деле; фактически; в конце концов
oikein (tдssд: hyvin)	очень, весьма
oikein (tдssд: oikeastaan)	собственно
oire	симптом, признак
ojentaa	выпрямлять/-тягивать; протягивать; по/передавать, вручать
oksennuttaa	тошнить (кого), тошно (кому); вызывать рвоту (у кого)
oksettaa	тошнить (кого), тошно (кому)
Ole hyvä.	Пожалуйста! Будь добр[а]!
Olkaa hyvä.	Пожалуйста! Будьте добры!
olla	быть, существовать, иметься; бывать; находиться; состояться; иметь; являться и проч.
olla eläkkeellä	быть на пенсии
olla kihloissa	обручаться; обручен, помолвлен
olla naimisissa	женат, замужем
olla velkaa	должен (кому); быть в долгах; быть в долгу (перед кем)
olla yötä (= yöpyä)	ночевать ollenkaan (> ei
ollenkaan)	> совсем не[т]
olo	пребывание; самочувствие; (во мн. ч.) условия, обстоятельства, обстановка
olohuone	гостиная
olut	пиво
oma	cвой; собственный; личный
omakotitalo	[частный односемейный] коттедж
omena	яблоко on (> olla) есть (> быть)
ongelma	проблема; вопрос
Onnea!	Поздравляю! Поздравляем!
onneksi	к счастью
Onneksi olkoon!	Поздравляю! Поздравляем!
onnellinen	счастливый; благополучный
onnellista uutta vuotta	С Новым годом!
onni	счастье; удача
onnistunut	удачный
ooppera	опера
oopperajuhlat	оперный фестиваль
opastus	инструктирование; руководство; экскурсия
opettaja	учитель, преподаватель; инструктор
opiskelija-asunto	квартира для студентов (в т. ч. общежитие)
opiskella	учиться, изучать, заниматься
oppia	*научиться, *выучить; *овладеть, *усвоить
oppilas	ученик; учащийся
orkesteri	оркестр; ансамбль
osata	уметь; знать; владеть
osoite	адрес
ostaa	покупать ostokset (> ostos) покупки
ostos	покупок
ostoslista	список покупок
otsa	лоб
ottaa	брать; отбирать/-нимать; снимать; принимать и проч.
ottaa aurinkoa	загорать
Oulu (kaupungin nimi)	Оулу (название города)
Oulujoki (joen nimi)	Оулуйоки (название реки)
ovi	дверь    
 	 
P	Наверх
paha	плохой, дурной, нехороший; злой; грубый; лукавый и проч.
pahaa tekee (tekee kipeдд, sattuu)	больно (кому), болит (3. лицо ед. ч.)
paikalla (= tavattavissa)	на месте
paikka	место
paikkakunta	местность
painaa	нажимать; печатать (книгу); тяготить, угнетать; весить
paistaa (auringosta)	светить
paistaa (ruoan valmistamisesta)	жарить; *испечь (хлеб)
paistettu	жареный
paitapusero	батник
pakastaa	замораживать; морозить
pakastin	морозильник
paketti	пакет, пачка, посылка
pakkanen	мороз
pakko	необходимость; надо, необходимо, обязательно
pala	кусок
palata	возвращаться
paljon	много
paljonko	сколько
palmu	пальма
palmupuu	пальма, пальмовое дерево
paluu	возвращение
palvella	обслуживать; служить
palvelupiste	стол/точка обслуживания
pankki	банк
pankkiautomaatti	банкомат
pankkikortti	банковская карточка
panna	класть, ставить; надевать (одежду) и проч.
parantua	улучшаться; выздоравливаться, вылечиваться
paras	самый хороший, [самый] лучший
paremmin	лучше
parempi	более хороший, лучший; лучше
pari	пара; несколько
Pariisi	Париж
parveke	балкон
pasta	паста, макаронные изделия
patonki	батон [белого хлеба]
patsas	статуя, памятник
pelata	играть (в футбол, карты и проч.)
pelkkä	только,один лишь; чистый, сущий
penkki	скамейка; сиденье; грядка
pensas	куст
perhe	семья, семейство
perille	предлог до + глагол: дойти, доехать, добраться, доставить и проч. на место.
perinteinen	традиционный
perjantai	пятница
permanto	пол (в доме); партер
persoonallinen	оригинальный; индивидуальный
peruna	картофель
perunalaatikko	картофельная запеканка
perustaa	основывать, создавать, учреждать
perällä	в задней части/конце/глубине (чего)
pestä	мыть; стирать
pesuaine	моющее средство; стиральный порошок
pesukone	стиральная машина
pesuohjelma	программа для стирки
pesutupa	прачечная
pian	скоро, вскоре
pieni	маленький; небольшой
Pietari	Санкт-Петербург
piha	двор
pikajuna	скорый поезд, экспресс
pikkuinen	маленький, крошечный; малютка
pikkujoulut	предрождественский веселый вечер (букв. "малое Рождество")
pikkusisko	младшая сестра pilkki (> kдydд
pilkillä)	блесна; подледный лов рыбы, зимняя рыбалка (> ходить на зимнюю рыбалку)
pilvi	облако, туча; травка (наркотик)
pilvinen	облачный, пасмурный
pimeys	темнота, тьма; мрак
pimeä	темный, мрачный; незаконный (товар, доходы и проч.)
pipo	вязаная шапочка [с кисточкой] (разг.) pisin (> pitkд) самый длинный; самый высокий, выше всех (> длинный; высокий) pitempi (> pitkд) длиннее; выше (> длинный; высокий)
pitkin	по (чему), вдоль (чего)
pitkä	длинный; высокий (рост человека)
pitkästä aikaa	Сколько лет, сколько зим!
pitkään (= kauan)	долго; давно
pitsa	пицца
pitää (= täytyy)	надо, нужно (кому), должен, следует
pitää (= jдrjestää)	устраивать, организовать, проводить
pitää (= tykätä)	нравиться (кому), любить
pizza	пицца
pohjoinen	север
poika	мальчик
poikaystävä	друг, парень, бойфренд
poimia	собирать (ягоды, грибы и проч.); на/под/от/выбирать
pois	прочь, вон
polku	тропа, дорожка, тропинка
polttaa	жечь; обжигать; курить
pomo	босс, шеф; большая шишка, туз (разг.)
porkkana	морковка
porkkanalaatikko	морковная запеканка
posti	почта
postikortti	открытка
postimaksu	почтовый сбор
postimerkki	почтовая марка
postipaketti	почтовая посылка
postitoimisto	почтовое отделение, почта; почтамт
potilas	пациент; больной
pudota	падать, валиться; по/снижаться
puhdistaa	очищать
puhelin	телефон
puhelinvastaaja	автоответчик
puhelu	телефонный разговор
puhua	говорить; выступать [с речью]
puinen	деревянный
puisto	парк, сквер
pukki (joulupukki)	Дед Мороз
pulla	булка, булочка (подразумеваются практически все виды сладкого пшеничного хлеба)
pullo	бутылка
punainen	красный; алый; рыжий
punaviini	красное вино
punaviinipullo	бутылка красного вина
Puola	Польша
puoli (ajasta ja mitoista)	половина, пол- (о времени и единицах измерения)
puoli (tila)	сторона (о пространстве)
puolikas	половина, половинка
purjevene	парусная лодка, яхта
purkki	банка; (прост. и шутл. о судне) посудина, корыто
pusero	блузка; кофта; батник; свитер и проч.
puu	дерево; дрова; древесина; лесоматериалы
puutalo	деревянный дом
puutarhaihminen	человек, любящий садоводство
puuvilla	хлопок
puuvillainen	хлопчатобумажный
pyrkiä	стремиться; пытаться, стараться; поступать (в учебные заведения)
pyry	метель, вьюга
pyryttää	мести, вьюжить; [на улице] метель/метет
pystyttää	ставить, устанавливать; возводить
pysyä	оставаться; держаться
pysähtyä	останавливаться
pyyhe	влажная тряпка для вытирания; влажная гигиеническая салфетка; полотенце
pyyheliina	полотенце
pyyhin (pyyhkimet)	(во мн. ч.) [стекло]очистители
pyykki	стирка; стираемое белье
pyytää	просить
pyöriä	вертеться, крутиться; вращаться; кружиться; работать (мотор, завод и проч.)
päin	на + вин.падеж ("окна на улицу"), в направлении; с + род. ("ветер с моря"); кроме того, в разных речевых оборотах
päivystävä	дежурный
päivä	день
Pдivдд!	Добрый день! Здравствуйте!
pärjätä	справляться, успевать
pää	голова; конец
pääasia	главная/основная идея; главное
pääkaupunki	столица
pääkonttori	главная контора
päälle	над (кем-чем); на (кого-что); надевать (одежду); включать (свет, радио и т. п.)
päällä	над (кем-чем); на (ком-чем); носить (одежду); включен (свет, радио и т. п.)
päänsärky	головная боль
päästä	добираться, доходить/-езжать; достигать; *поступить/*окончить (учебные заведения) и пр.
päätie	главная дорога, магистраль
päättää	кончать, о/заканчивать, завершать; решать, принимать решение
päätös	решение; конец, окончание, исход
pöytä	стол; столик (в ресторане)    
 	 
R	Наверх
Raahe (kaupungin nimi)	Раахе (название города)
raaka	неспелый, незрелый, сырой (пища); чистый, неразбавленный (жидкость); жестокий, зверский (преступление); мерзкий, резкий (погода, ветер)
radio	радио; радиовещание; радиоприемник
raha	деньги; монета, купюра; валюта
raide	колея, [рельсовый] путь; рельс
rai­tiovaunu	трамвай
rai­tiovaunulippu	трамвайный билет
rakas	дорогой, милый
rakastaa	любить
rakentaa	строить
rankasti	сильный, проливной (дождь); тяжелый, суровый (работа, день)
Ranska	Франция
ranskalainen	француз; французский
ranskalaiset (perunat)	картофель фри
ranta	берег
rasittaa	утомлять; обременять
rasittava	утомительный; изводящий (человек)
rauha	мир; покой
rauhallista joulua	С Рождеством Христовым! (букв. "Желаю [вам] спокойного Рождества/рождественского покоя!"
rautatieasema	железнодорожная станция; ж.-д. вокзал
ravintola	ресторан
reikд	дырка
reippaasti	бойко, бодро; значительно
reissu (= matka)	поездка (разг.)
reistata	барахлить; пошаливать (разг.)
remontoida	ремонтировать
rentoutumisharjoitus	релаксационная гимнастика
resepti	рецепт
riippua	висеть; зависеть (от кого-чего)
riittдд	хватать; достаточно (чего); хватит! довольно!
rikas	богатый
rikkoa	ломать, разбивать; нарушать; менять (деньги)
risteily	круиз
ristiдiset	крестины
rivitalo	блокированный дом
Rooma	Рим
rosolli	винегрет [с селедкой]
rouva	дама, госпожа, женщина; супруга, хозайка
Rovaniemi (kaupungin nimi)	Рованиеми (название города)
runsas	обильный; с лишним
ruoka	еда, пища, продукты; корм; блюдо
ruokailu	питание
ruokailuvдline	столовые приборы
ruokalista	менью
ruokaosasto	продовольственный отдел
ruotsalainen	швед; шведский
Ruotsi	Швеция
ruotsi	шведский язык
Rymдttylд (paikan nimi)	Рюмяттюля (название местности)  
 	 
S	Наверх
saada (vastaanottaa)	получать, принимать
saada (voida)	мочь, можно
saada	получать
saada selvдд	понимать; *узнать, *выяснить
Saako olla…? (Otatko…?)	Хотите/хочешь [еще] …? Берите/берешь [еще] …? Можно вам/тебе [еще] …?
saame	саамский язык
Saana (tunturin nimi)	Саана (название сопки в Лапляндии)
saapas	сапог
saapua	прибывать, приходить, приезжать и т. п.
saari	остров
Saarijдrvi (paikan nimi)	Саариярви (название местности)
saaristo	архипелаг
sadas	сотый
Saimaa (jдrven nimi)	Сайма (название озера)
sairaala	больница
sairaanhoitaja	медсестра
sairas	больной
sairasloma	отпуск по болезни
sairastaa	болеть, хворать
sairastua	*заболеть, *захворать
Saksa	Германия
saksalainen	немец; немецкий
salaatti	салат
salama	молния
saldo	сальдо
sali	зал
sama	тот же [самый]
samaa mieltд	согласен
samoin	так же, таким же образом; одинаково
sanakirja	словарь
sanoa	*сказать
sata	сто
sataa	идет дождь
Sata-Hдme (alue Suomessa)	Сата-Хяме (область в Финляндии)
satama	гавань, порт
sattua (olla kipeд)	больно, болеть
sattumalta	случайно
sauna	сауна, баня
Savo (alue Suomessa)	Саво (область в Финдянлии)
Savonlinna (kaupungin nimi)	Савонлинна (название города)
savusauna	черная баня
se	он; этот
Se tekisi... (= Se maksaa…)	Это будет … Это стоит …
seinд	стена
Seinдjoki (kaupungin nimi)	Сеняйоки (название города)
seiska	семерка
seitsemдn	семь
Seitsemдn veljestд (romaanin nimi)	Семеро братьев (название романа)
seitsemдnkymmentд	семьдесять
seitsemдntoista	семнадцать
seitsemдs	седьмой
seitsemдstoista	семнадцатый
sekaisin	в беспорядке; расстроенный, запутанный и проч.
selkд	спина
sellainen	такой, таков; подобный
selleri	сельдерей
selvitд	про/выясняться; справляться (с чем); отправиться (от чего); обходиться (чем, без чего); *протрезвиться
selvд	ясный; четкий, отчетливый; понятный; трезвый
semmonen (= sellainen)	такой, таков; подобный (разг.)
Senaatintori	Сенатская площадь
sentti	цент; (разг.) сантиметр
sentддn	все же, все-таки
serkku	двоюродный брат
setti	комплект, набор (чего)
setд	дядя
seura	обшество, компания
seuraava	следующий
siellд	там
sieltд	оттуда
sieni	гриб
sienipiirakka	пирог/пирожок с грибами
siesta	сиеста siihen (> se) > он; этот (иллятив ед.ч.)
siika	сиг
siinд	здесь, тут; вон; вот (в разных оборотах речи)
siirappi	патока
siirtдд	передвигать/-мещать/-возить; переносить, откладывать и проч.
siis	значит; следовательно, итак
siitд	> он; этот (элатив ед.ч.) (кроме того, в разных оборотах речи)
siivota	убирать
silli	сельдь, селедка
silloin tдllцin	время от времени, временами sillд (> se) > он; этот (адессив ед.ч.)
sillд lailla (= niin)	так, таким образом; вот так
silta	мост
silti	все же, все-таки; тем не менее
sininen	синий, голубой
sinkku	одиночка; сингл
sinne	туда
Sinuhe egyptilдinen (romaanin nimi)	Синухе, египтянин (название романа)
sinuttelu	обращение на "ты"
sinд	ты
sipuli	лук, луковица
sisko	сестра
sisдltдд	содержать; включать
sisддn	внутрь; предлог/приставка в[o] (+ глагол)
sitten	потом, затем; [тому] назад и проч.
sivutie	второстепенная дорога; проселочная лорогая
skool	За ваше здоровье! (со шведского)
snapsi	рюмка водки (с немецкого)
sohva	диван
soitella	звонить, созваниваться
soitellaan	Пока! До встречи! (букв.) Давай будем созваниваться!
soittaa	звонить (по телефону); играть (на инструменте)
soitto	(телефонный) звонок; игра (на инструменте)
sokeri	сахар
sopia	договариваться; мириться; помещаться; подходить; годиться
sopimuspaperi	договор, контракт; договоренность (разг.)
sopiva	подходящий, удобный; уместный
sovittaa	примерять; аранжировать, инсценировать и проч.
sovitus	примерка; аранжировка, инсценировка и проч.
sovituskoppi	примерочная
spagettia	спагетти (партитив ед.ч.)
stipendi	стипендия
stressi	стресс
stretch-ominaisuus	эластичность, эластичные качества (одежды)
suihku	душ; струя; фонтан
sukkahousut	калготки
sukujuhla	семейное празднество (с участием всей родни)
sukukuva	фотография родственников, семейный портрет
sukulainen	родственник
sukunimi	фамилия
sulaa	таять, оттаивать
sulhanen	жених
suljettu	закрыт[ый]
sulkea	закрывать
sunnuntai	воскресенье
suoja	у/прикрытие (от чего); защита (от чего); оттепель
suola	соль
suoli	кишка
suomalainen	финн; финский
Suomenlahti	Финский залив
Suomenlinna (linnoitus Helsingissд)	Свеаборг (крепость в Хельсинки)
Suomi	Финляндия
suora	прямой
suoraan	прямо
suositella	рекомендовать
suosittu	популярный
surkea	жалкий; плохой; печальный
suu	рот
suuri	большой; крупный, великий
Sveitsi	Швейцария
syksy	осень
syntyд	рождаться; возникать
sytytys	за/раз/поджигание
syvд	глубокий
syvддn	глубоко
syyskuu	сентярбь
syцdд	есть, кушать
syцtдvд	съедобный; съестное
sдhkцposti	электронная почта
sдhly	разновидность флорбола, очень популярная в Финляндии
sдilyttдд	хранить, держать; сохранять
sдnky	кровать; постель
sдrkeд	ломать, разбивать; болеть
sдд	погода
sддtiedotus	сводка погоды, метео[рологическая ]сводка
sцpц	хорошенький, симпатичный    
 	 
T	Наверх
taas	опять, снова; с свою очередь, зато
tai	или
taide	искусство
taidenдyttely	художественная выставка
taitaa	уметь, знать, владеть (чем); пожалуй
taitava	умелый, знающий, искусный, тонкий и проч.
taivas	небо; царство небесное
tajuta	воспринимать; [о]сознавать, постигать; понимать
takaisin	обратно, назад
takana	за (кем-чем); сзади, позади
takki	пальто; плащ; куртка; пиджак
taksi	такси
talkoot	субботник, восресник
Tallinna (Viron pддkaupunki)	Таллинн (столица Эстонии)
talo	(tarkoittaа tдssд kahvilaa) дом (подразумевается кафетерий)
talo	дом
talouskauppa	магазин хозяйственных товаров
talvi	зима
talvirengas	зимняя покрышка
talviuinti	купание в проруби
tammikuu	январь
Tampere (kaupungin nimi)	Тампере (название города)
tango	танго
Tangomarkkinat	Фестиваль танго (букв. "ярмарка танго2 или "танго-рынок") (крупное событие популярной музыки, проводимое ежегодно в г.Сейняйоки)
tankata	заправлять (машину горючим); зубрить
Tanska	Дания
tanskalainen	датчанин; датский
tanssia	танцевать; плясать
tapa	обычай, традиция; привычка; тон, манеры; способ, образ
tapaaminen	встреча; свидание
tapani (= tapaninpдivд)	второй день Рождества
tapaninpдivд	второй день Рождества
tapella	драться; спорить; бороться (с кем-чем)
tarjoilija	официант
tarjolla	предлагаемый выбор/ассортимент товаров/ продуктов/блюд и проч. (в магазине, ресторане, дома и т. д.)
tarjota	предлагать, предоставлять; подавать; угощать
tarkasti	точно; четко, отчетливо; аккуратно, тщательно, основательно, подробно и проч.
tarkka	точный; четкий, отчетливый; острый, меткий; аккуратный и т. д. (см. выше)
tarkkailla	наблюдать; следить (за кем-чем)
tarkoittaa	иметь в виду, подразумевать; значить, o[бо]значать; предназначать
tarkoitus	смысл; цель; назначение; намерение
tarpeeksi	достаточно
tarpeellinen	нужный, необходимый
tarvis	нужно, надо, необходимо (разг.)
tarvita	нуждаться (в ком-чем), требовать (чего), требоваться; нужно, надо tarvitse (> ei
tarvitse)	> не надо
tasan	ровно
tasaoksainen	с соразмерными ветвями, симметрический (прежде всего, о рождественской елке)
taulu	картина, полотно; доска; табличка и проч.
tauti	болезнь, заболевание, недуг
tavallaan	в некотором/известном смысле/роде; как бы
tavallinen	обычный, обыкновенный, простой
tavallisesti	обычно, обыкновенно
tavara	товар, изделие; вещь; груз
tavaratalo	универмаг
tavata	встречать[ся]; видеть[ся]; навещать
te	вы
teatteri	театр
tee	чай teette (> tehdд) вы делаете (> делать)
tehdд	делать; совершать; изготовлять; состаялять и пр.
teitittely	обращение на "вы"
tekeminen	отглагольное существительное (> делать), одним словом не переводимое, т.к. встречается прежде всего в разных оборотах речи (напр. ei mitддn tekemistд -- "нечего делать")
televisio	телевизор
telkkari (= televisio)	телик (разг.)
teltta	палатка; шатер
Temppeliaukio (aukio Helsingissд)	Темппелиаукио (площадь в Хельсинки)
teos	произведение; труд
terassi	терраса
terve (ei sairas)	здоровый
terve (tervehdys)	Привет! Здоруво!
tervehdyksiд	приветствия
terveisiд	привет[вы], пожелания
tervetuloa	Довро пожаловать! Милости просим! С приездом!
terveys	здоровье
terveysasema	здравпункт
terveyskeskus	здравцентр, медпункт, поликлиника
Thaimaa	Таиланд
tie	дорога, шоссе; путь
tietenkin	конечно tietenkддn (>
tietenkin)	конечно не (+ глагол); нет, конечно
tietokilpailu	викторина
tietokonepeli	компьютерная игра
tietysti	конечно, разумеется
tietдд	знать; известно (кому)
tiistai	вторник
tila	место, пространство; помещение; имение, ферма; состояние, положение
tilata	заказывать; подписываться (на газету и т. п.)
tili	счет; отчет; получка, зарплата (разг.)
tilinumero	номер счета
tilli	укроп
tiskikone	посудомоечная машина
tiskipцytд	кухонная мойка
todellakin	действительно; в самом деле; поистине, истинно; (в вопросе также) неужели
todennдkцisesti	вероятно, очевидно
tohtori	доктор
toimia	действовать, работать; служить, быть (кем)
toinen – toisensa (resiprookkinen)	друг друга (номинатив + род.-вин. п. ед. ч.)
toinen (= muu)	другой, иной
toinen (jдrjestysluku)	второй
toipua	выздоравливаться, поправляться; оправляться
toisillemme	(> toinen – toisensa) друг другу (> друг друга) (номинатив ед. + аллатив мн. ч.)
toisistaan	(> toinen – toisensa) друг друга (> друг друга) (номинатив ед. + элатив мн.ч.)
toissapдivдnд	позавчера, третьего дня
toivottaa	желать
toivottavasti	надеюсь, будем надеяться
tori	рынок; площадь
torikahvila	кафе[-палатка] на рынке
torstai	четверг
tosi (= todella)	действительно, правда, право
tosi (totuus)	правда; истина
tosiaan (= todella)	в самом деле; действительно, правда, право totta (> tosi) > правда, истина (партитив ед. ч.)
totta kai	конечно, разумеется
tottua	привыкать; осваиваться; акклиматизироваться
totuus	правда; истина
toukokuu	май
tuhannes	тысячный
tuhat	тысяча
tuikkia	мерцать, мелькать, мигать
Tukholma	Штокгольм
tukossa	[нос] заложен; [в движении] затор; [экспорт] приостановлен; [канализация] засорилась
tulehtua	воспаляться
tuliainen	гостинец
tuliaislahja	подарок гостя хозяевам (часто из другого города или из-за рубежа)
tulla	прибывать/-ходить/-eзжать/-летать и т. п.
tulossa	инессив ед. ч. отглагольного сущ. tulo (>
tulla);	употребляется в разных значениях, напр. (о гостях) будут, придут; (о новых фильмах) вскоре [в нашем театре]; (о Рождестве) уже близко и пр.
tulostin	принтер, печатающее устройство
tumma	темный; смуглый
tunnelmallinen	уютный, приятный, интимный
tunnusluku	шифр, код
tuntea	чувствовать, ощущать; знать; узнавать
Tuntematon sotilas (romaanin nimi)	Неизвестный солдат (название романа)
tunti	час; урок
tuntua	чувствоваться, ощущаться; казаться
tunturi	сопка, гора с беслесной вершиной в Лапландии
tuo	тот; этот
tuoda	приносить/-водить/-возить; ввозить, импортировать
tuolla	там, вон
Tuomiokirkko	кафедральный собор
tuommoinen (= tuollainen)	такой
tuoppi	кружка
tuore	свежий
tuota (miettiessд sanottu)	так, вот, ну и т. п. (пустое словечко при преобращении мыслей во фразы)
tupaantuliaiset	новоселье
tupaantuliaislahja	подарок на новоселье
tupakka	табак; сигарета
turha	напрасный, бесполезный, тщетный; [из]лишний
turhaan	напрасно, тщетно, зря
turisti	турист
Turku	Турку
tusina	дюжина
tutkia	изучать, исследовать; расследовать; рассматривать
tuttu	знакомый
tutustua	знакомиться; ознакомиться (с кем-чем)
tuuhea	густой; пушистый
tuulla	ветер дует
TV-dialogi	диалог по ТВ
tyhjentдд	опустошать, опорожнять; очищать, освободить; разряжать; выпускать и проч.
tyhjд	пустой
tyhjдkдynti	холостой ход
tyhmд	глупый
tyhmдsti	глупо
tykдtд	любить, нравиться (кому); хотеть; думать (разг.) (со шведского)
tylsд	тупой, отупелый; скучный
tyttц	девочка; девушка
tyttцystдvд	девушка
tytдr	дочь, дочка
tyynyliina	наволочка
tyynysota	подушечный бой
tyytyvдinen	довольный, удовлетворенный
tyц	работа, труд; дело
tyцasia	служебное дело
tyцhuone	рабочий кабинет, рабочее помещение; мастерская
tyцkaveri	коллега, товарищ по работе
tyцmatka	путь на работу/с работы; командировка
tyцntдд	толкать; (в дверях) от себя; совать
tyцpaikka	место работы; рабочее место
tyцpдivд	рабочий день
tyцtoveri	товарищ по работе, коллега
tyцviikko	рабочая неделя
tдhti	звезда
tдhдn	сюда
tдllainen	[вот] такой
tдmmцinen (= tдllainen)	[вот] такой
tдmд	этот, сей
tдnne	сюда tдnд (> tдmд) > этот, сей (эссив ед. ч.)
tдnддn	сегодня
tдrkeд	важный
tдssд	здесь
tдti (isдn tai дidin sisko)	тетя (сестра отца или матери)
tдti (naisesta)	тетя, тетка (любая взрослая женщина)
tдynnд	полон (чего); переполнен; (о ресторане) мест нет
tдysikuu	полная луна, полнолуние
tдyttдд (iдstд puhuttaessa)	исполняться (кому) (о возрасте)
tдytyy	надо, нужно; должен; следует
tддllд	здесь, тут
tддltд	отсюда
tцnдistд	*толкнуть; * задеть    
 	 
U	Наверх
uida	плавать; купаться
uima-allas	[плавательный] бассейн
uimahalli	закрытый [плавательный] бассейн
uimapuku	купальник
ukki	дедушка
ukkonen	гром; гроза
ukonilma	гроза
ulkomaalainen	иногранец
ulkomailla	за границей, за рубежом
ulkona	на улице; [обедать/ужинать] в ресторане
ulos	на улицу; [пойти] в ресторан
umpisuolentulehdus	аппендицит
umpisuoli	аппендикс
unelma	мечта
uni	сон; сновидение
unohtaa	забывать
upea	роскошный, великолепный, пышный, шикарный
urheilla	заниматься спортом
urheiluosasto	отдел спортивных товаров/принадлежностей
useimmiten	чаще всего
uskoa	верить; полагать, думать; поручить (кому) uudempi (> uusi) более новый, новее (> новый)
uudestaan	снова, опять
uusi	новый    
 	 
V	Наверх
vaan (= vain)	только, лишь
vaan	[не то,] а [это]
vaarallinen	опасный
Vaasa (kaupungin nimi)	Вааса (название города)
vaate	одежда; платье
vaatekauppa	магазин [готовой] одежды/готового платья
vaatepussi	мешок для хранения одежды
vaateripustin	вешалка
vahingossa	по ошибке; нечаянно, ненамеренно; случайно
vahva	прочный, крепкий; сильный, мощный; острый
vai	или; вот [оно что!]
vaihtaa	менять; обменивать; заменять; пересаживаться и проч.
vaihto	[с]мена, обмен, размен, перемена; пересадка и пр.
vaikea	трудный; тяжелый; серьезный
vaikka (= esimerkiksi)	на пример, скажем
vaikka	хотя, хоть; [кто/что/куда/сколько] угодно
vaikuttaa	влиять, воздействовать; казаться
vaille	без (кого-чего) (часто о времени); лишен (чего); чуть меньше (чего)
vaimo	жена; супруга
vain	только, лишь
valita	вы/из/от/подбирать; набирать [номер]
valitettavasti	к сожалению
valittaa	стонать; жаловаться, ныть; подавать жалобу, апеллировать
valkoinen	белый
valkopyykki	нецветное/белое белье
valkoviini	белое вино
vallata	занимать; захватывать/-воевывать/-владевать; охватывать/-владевать
valmis	готовый
valo	свет; огонь
valoisa	светлый
valokuva	фотография, снимок
vanha	старый, пожилой; старинный, древний; недействительный, негодный; бывший, прежний; подержанный, [по]ношенный
vanhemmat	ролители
vapaa	свободный; вольный; вакантный; незанятый; бесплатный и проч.
varata	заказывать; бронировать; запасать[ся]; записываться (на прием) и проч.
varattu	заранее заказынный; занят[о]
varmaan	наверно[е]; вероятно, верно, должно быть; пожалуй
varoa	остерегаться, беречься, опасаться и проч.
varottaa	предупреждать, [пред]остерегать
varovasti	осторожно
varsinkin	особенно, в особенности
varten	для (кого-чего)
Vartiokylд (kaupunginosa Helsingissд)	Вартиокюля (один из районов Хельсинки)
varvas	палец ноги vasemmalle (> vasen) налево (> левый)
vasen	левый
vasta (= ei ennen kuin)	не раньше
vasta (= vihta)	банный веник (в Восточной Финляндии)
vasta (= дsken)	только что
vastaan	навстречу; против
vastaanotto	прием; регистрация; регистратура
vastaanottoapulainen	секретарь в премной (у врача)
vastapддtд	напротив, против (кого-чего)
vastata	отвечать (на/за что); откликаться; соответствовать (чему)
vastaus	ответ
vatsa	живот, желудок
vatsakipu	боль в желудке/животе
vauva	младенец, малыш, малютка
WC (veesee)	туалет, уборная
vegetaristi	вегетарианец
veikata	играть в спортлото; [пред]полагать; от/угадывать
veistos	скульптура
veitsi	нож
veli	брат
velka (olla velkaa)	долг (должен)
vene	лодка; катер, яхта
veneillд	кататься на лодке (катере, яхте)
Venetsia	Венеция
Venдjд	Россия, Русь
venдlдinen	россиянин; русский
Verona	Верона
vesi	вода
vessa	туалет
vessaharja	туалетная щетка
vessapaperi	туалетная бумага vettд (> vesi) воды? (> вода) (партитив ед. ч.)
vetдд	тянуть, тащить; (в дверях) к себе; вытаскивать; натягивать; за/проводить и проч.
video	видео[магнитофон]
viedд	нести, от/yносить, вести, от/yводить и т. п.; вывозить, экспортировать и проч.
vielд	еще
vieras	незнакомый, чужой; незнакомец; посторонний, инородный; гость, посетитель, клиент
vierashuone	комната для гостей
viereen	рядом (с кем) (куда?)
vieressд	рядом (с кем) (где?); возле, подле, у (кого-чего)
viesti	известие, сообщение; эстафета
viettдд	проводить (время); праздновать, отмечать
vihannes	овощь
vihta	банный веник (в Западной Финляндии)
vihtoa	париться веником
viides	пятый
viidestoista	пятнадцатый
viikko	неделя
viikonloppu	конец недели, уикэнд, выходные, суббота-воскресенье
viikonloppusiivous	уборка квартиры в выходные
viikonpдivд	день недели
viime	прошлый, предыдущий
viimeinen	последний
viimeksi	[в] прошлый раз
viineri	венская булочка
viini	вино
viisi	пять
viisikymmentд	пятьдесят
viisitoista	пятнадцать
viisivuotias	пятилетний
viitata	поднимать руку; по/yказывать; ссылаться (на кого-что) и проч.
viitonen	пятерка viitsi (> дlд
viitsi)	> Не надо! Брось! Перестань!
viitsiд	[не]охота делать что-то; (в просьбах) пожалуйста (+ императив), не трудно ли …?
vika	неисправность, повреждение, дефект; проблема; порок; недостаток; вина
vilkaista	*взлянуть, *посмотреть и т. п.
villasekoitehousut	брюки, изготовленные из смеси шерстяных и других, часто синтетических волокон
vilustua	простужаться
vilustuminen	простуда
vilustunut	простуженный
vipata	брать/давать в долг (разг.)
virkailija	служащий
Viro	Эстония
virolainen	эстонец; эстонский
virta	течение; ток, питание; поток
visa (luottokortti)	кредитная карточка ВИСА
vitsi	шутка, анекдот
voi	[сливочное] масло
Voi hyvin.	(при прощании) Будь здоров! Всего хорошего!
Voi.	Ах! Ой!
voida	мочь, можно; чувствовать себя
voittaa	побеждать; выигрывать; преодолевать и проч.
vuodenaika	время года vuokralla (> asua
vuokralla)	> жить в наемной квартире, снимать квартиру
vuokrata	сдавать в аренду/снимать, арендовать (квартиру) ; отдавать/брать напрокат vuonna (> vuosi) в каком-то году (> год) (эссив ед. ч.)
vuoronumero	номер в очереди
Vuosaari (kaupunginosa Helsingissд)	Вуосаари (один из районов Хельсинки)
vuosi	год
-vuotias	-летний
vyц	пояс; ремень
vдhentдд	уменьшать; сокращать; ужерживать, вычетать
vдhдn	мало, немного
vдliaika	промежуток времени; интервал; антракт; перемена; промежуточное время
vдlissд	между (кем-чем) (где?)
vдlittцmдsti	немедленно; непосредственно, непринужденно
vдlttдд	избегать (кого-чего)
vдri	цвет; краска
vдrinen	какого-то цвета
vдsynyt	усталый; утомленный
vдsyttдvд	утомительный; неинтересный, скучный
vдsyttдд	утомлять; чувствовать усталость, *устать
vддrд	кривой; неправильный, ошибочный; не тот; фальшивый, лже-    
 	 
Y	Наверх
yhdeksдn	девять
yhdeksдnkymmentд	девяносто
yhdeksдntoista	девятнадцать
yhdeksдs	девятый
yhdeksдstoista	девятнадцатый
yhdessд	вместе; совместно
yhdestoista	одиннадцатый
yhdistдд	соединять; объединять; соединять, сочетать и пр.
yhtiцkokous	общее собрание акционеров
yhtд	одинаково, так же как и проч.
yhtдkkiд	внезапно, вдруг
yhtддn	совсем; [хоть] сколько-нибудь
yhд	все еще
ykkцnen	единица, номер один
yksi	один
yksin	один
yksinдinen	одинокий
yksitoista	одиннадцать
yksiц	однокомнатная квартира
yleensд	вообще; обычно, как правило
yleislддke	универсально действующий препарат; панацея
yleislддkдri	терапевт, врач общей практики
yli (kadun yli)	через (улицу)
yli	сверх; больше, более, свыше, выше, старше (чего)
ylihuomenna	послезавтра
ylioppilas	окончивший гимназию, получивший среднее образование; студент (в вузе)
ylioppilasjuhla	праздник по поводу окончания гимназии
ylioppilaslakki	[белая] фуражка окончившего гимназию
ylirasittunut	переутомленный
ylдkaappi	верхний шкаф
ylдkerta	верхний этаж
ylцs	вверх
ymmдrtдд	понимать
ympдri	вокруг (кого-чего); круглый [год, сутки и т. п.]
yrittдд	стараться, пытаться; пробовать
ysi	девятка
yskд	кашель
yskдnlддke	лекарство от кашля
ystдvд	друг, подруга; приятель
ystдvдllinen	приветливый, любезный, дружелюбный; дружественный
yц	ночь    
 	 
A	Наверх
дiti	мать, мама
дkkiд	быстро, моментально; вдруг, внезапно; неожиданно
дlд	не (2. лицо ед. ч. императива -- это глагол!)
Дlд ihmeessд!	Ни в коем случае! Неужели?!
Дlд nyt!	Да что ты!
дlд viitsi	Не надо! Брось! Перестань!
ддni	звук; голос; тон; шум; очко, балл
